#####################################################
#....<..............................................#
#.....................................###...........#
#...........>..........................#............#
#..$.....###########.....**............#............#
#.....$..#M.....*......................#............#
#........#.M....*.....................###...........#
#####################################################
